20 10
11111112211111111111
11112222111111111111
11111122111111122111
11111111111111111111
11111111131111111111
11111112233111111111
11111111223331111111
11111111333111111111
11111111113122111111
11111111111111111111